{
	"texture": "terrain",
	"tileSize": 16,
	"tiles":
	{
		"#":
		{
			"x": 7,
			"y": 0
		},
		"=":
		{
			"x": 17,
			"y": 1
		}
	},
	"map":
	[
		"................................",
		"................................",
		"................................",
		"................................",
		"........====....................",
		"................................",
		"..............====..............",
		"................................",
		"................................",
		"................................",
		"....######......................",
		"................................",
		"................................",
		"................................",
		"................................",
		"................................",
		"................................",
		"................................",
		"................................",
		"################################"
	]
}